###############
# #A          #
# ####        #
#             #
# ####   #    #
# #H     #    #
# #########   #
# A#      #   #
####    # #   #
#       ###   #
# # #         #
#H# #         #
### #         #
#F  #         #
###############